1,2,2,2,2,2,2,2,0,0,2,2,2,2,3
6,0,0,0,0,0,0,0,0,0,0,0,0,0,8
6,0,0,0,0,0,0,0,0,0,0,0,0,0,8
6,0,0,0,0,0,0,0,0,0,0,0,0,0,8
6,0,0,0,0,0,0,0,0,0,0,0,0,0,8
6,0,0,0,0,0,0,0,0,0,0,0,0,0,8
6,0,0,0,0,0,0,0,0,0,0,0,0,0,8
6,0,0,0,0,0,0,0,0,0,0,0,0,0,8
6,0,0,0,0,0,0,0,0,0,0,0,0,0,8
6,0,0,0,0,0,0,0,0,0,0,0,0,0,8
6,0,0,0,0,0,0,0,0,0,0,0,0,0,8
6,0,0,0,0,0,0,0,0,0,0,0,0,0,8
6,0,0,0,0,0,0,0,0,0,0,0,0,0,8
6,0,0,0,0,0,0,0,0,0,0,0,0,0,8
2,2,2,2,2,2,2,2,2,2,2,2,2,2,2
